#################~~~~~~~~~~
#################    =~   #
     ~~~~    ==   =~==~   #
     ~~S~~  ====  ==~=~~  #
     ===~~   #==   =~=~~  #
     ===~~  ###    =~     #
     ===~~  ##   ###~     #
 =~              ## ~   ###
 =~      ##  == =~ =~   ###
      ==###  == =~      ###
##########   ==        ~###
~~~~~~~~         ~~~~##~   
 ### # # ### ### ====##=   
 # # # # #   # #   ==~~~=  
 ### # # #   ###   =~~~==  
 #   # # #   #     =##~E   
 #   ### ### #     =##     
~~~~~~~~~~~~~~~~~~~~~~~~~~~